111111111111111111111
109700802010200000001
101210101010101010101
106200000310302202001
101010101010101010101
105820042212002002001
101310101010101010101
100022002010200300001
101310101010121010101
100000002410022200001
101210101010101010101
100200420012200420001
141010101010101010101
127200000210000000001
101210101410101010141
100600000010000004001
111111111111111111111
