111111111111111111111
109700802000200000001
101210101010101010101
106200000300302202001
101010101010101010101
105820042202002002001
101310101010101010101
100022002000200300001
101310101010121010101
100000002420022200001
101210101010101010101
100200420022200420001
141010101010101010101
127200000220000000001
101210101410101010141
100600000000000004001
111111111111111111111
